232323230101010-
323232321010101-
245454230101010-
354545323232323-
245454232323232-
354545323232323-
245454232323232-
354545323232323-
232323232323232-
323232323232323